
>> Торговцы:

BCLthr		кожевенник в Сан-Брамин
GCPit		Пит в ГаражСити
PCBrtrA		торговец оружием
PCBrtrB		торговец барахлом
PCBrtrC		торговец нарядами
PCBrtrD		торговец закусочной
PCDrgdlr	пушер в трущобах
PCAtmBrt	торговец атомщиков
RCIntndt	интендант рейнджеров
DCWtrBrt	водный торговец в Каса-Гранде
SCIntndt	интендант Братства Стали
TCBarter	интендант жестянщиков
NCApcAst	последователи апокалипсиса в КНуэва
NCHimadr	химадор в КНуэва

>> Бармены:

GCBarmen
FCBarmen
DCBarmen	появляется только во фриплее
PCCasBar
PCRngBrt

>> Постоянные напарники:

GCEugene	Гараж-Сити	Юджин
VVCScnc		Убежище 27	ученый
ICApoc		Инферно		Последователь Диана
ICPaladn	Инферно		паладин БС
HCPrisnr	Эрмосильо	заключенный
VCRobot		Вилла		робот в склепе (только фриплей)

>> Локальные напарники (только на время квеста в пределах одной или нескольких конкретных карт):

JCRanger	Шакалы		пленник-рейнджер (до выхода из локации Шакалов)
FCMadre		Флагпул		мадре (до перехода в другой район Флагпула)
RCPresly	Рейнджеры	рейнджер Пресли на дамбе (только в пещере Гьерс-Уош)
PCPrtznD	Феникс		партизан
MCMtlBoy	Мотель		пленник (до выхода из локации Мотеля)
MCPrison	Каса-Гранде	заключенный магистральщик в ратуше (до перехода в другой район)

>> Технические напарники (приобщаются только для перехода на другую карту, затем сразу же отсоединяются):

GCImgrnt	Гараж-Сити	иммигрант
FCTraper	Флагпул		траппер в лагере Уайнон
FCCrvBos	Флагпул		караванщик в Флагпуле для перехода в Феникс
PCCrvBos	Феникс		караванщик в Фениксе для перехода в Ту-Сан
TCCrvBos	Ту-Сан		караванщик в Ту-Сане для перехода в Пуэрто
DCAlien		Каса-Гранде	приезжий
DCCtznD		Каса-Гранде	житель на ж/д станции
RCBezhA		Рейнджеры	мать-беженка на дамбе
RCBezhB		Рейнджеры	ребенок-беженец на дамбе
FCFarmA		Флагпул		фермер
